........
.....O..
........
..X.....
........
